{
	"id": 2,
	"blockSize": 4,
	"terrainTextureName": "sand",
	"playerTextureName": "sand",
  "textureShininess": 0,
	"size": {
		"x": 37,
		"y": 11
	},
	"spawn": {
		"x": 0,
		"y": 5
	},
	"finish": {
		"x": 10,
		"y": 2
	},
	"map": [
    "00000100000",
    "01110101110",
    "01011111010",
    "01110101110",
    "00000100000",
    "01110101110",
    "01011111010",
    "01110101110",
    "00000100000",
    "01110101110",
    "01011111010",
    "01110101110",
    "00000100000",
    "01110101110",
    "01011111010",
    "01110101110",
    "00000100000",
    "01110101110",
    "01011111010",
    "01110101110",
    "00000100000",
    "01110101110",
    "01011111010",
    "01110101110",
    "00000100000",
    "01110101110",
    "01011111010",
    "01110101110",
    "00000100000",
    "01110101110",
    "01011111010",
    "01110101110",
    "00000100000",
    "01110101110",
    "01011111010",
    "01110101110",
    "00011111000"
	]
}
