{
	"id": 3,
	"blockSize": 4,
	"terrainTextureName": "snow",
	"playerTextureName": "ice",
  "textureShininess": 10,
	"size": {
		"x": 25,
		"y": 16
	},
	"spawn": {
		"x": 0,
		"y": 5
	},
	"finish": {
		"x": 17,
		"y": 10
	},
	"map": [
    "0000010000000000",
    "0000011110000000",
    "0000010000000000",
    "1111110000000000",
    "0000010000000000",
    "0000011000000000",
    "0000010000000000",
    "0000011111000000",
    "0000010000000000",
    "0000011000000000",
    "0000010000000000",
    "0000011111100000",
    "0000010000000000",
    "0000011111111110",
    "0000010000000000",
    "0000011100000000",
    "0000010000000000",
    "0000011111000000",
    "0000010000000000",
    "0000011111100000",
    "0000010000000000",
    "0000011110000000",
    "0000010000000000",
    "0000011111100000",
    "0000010000000000"
	]
}